*****
*   *
* 0 *
*   *
*****