********************************
*   *       *      *      *    *
* ****** ****** ****** ******* *
* *    * *    * *      *       *
* * ** * ****** *      ******* *
* *    * *      *            * *
* *    * *      ****** 0****** *
********************************