**************************************************
*******     **************************************
******       *******************  ******  ********
*****   **    ******************  ******  ********
****   ****   ******************  ******  ********
****   ****                               ********
*****   **    ************************************
******       *************0***********************
*******     **************************************
**************************************************